111111111111111
111110000C01101
110C0000E001001
110000111000011
1000F0010F00001
11010P011100C01
111111111111111
