1111111111111111111
1111111111111111111
11111110P0111111111
110C000000010001111
1100000000000101111
110000010100E001111
1101001C0001C011111
1111111111111111111
1111111111111111111
