1111111111111111111
1111111111111111111
1111111111111111111
1111111111111111111
1111111111111111111
111111100P111111111
110C000000010001111
1100000000000101111
100000010100E000001
1101001C0001C011111
1111111111111111111
1111111111111111111
1111111111111111111
