111111111111111
10CE00000010001
100000000000001
100000001000001
101000P00000011
111111111111111