11111111
100000P1
10000CE1
11111111