1111111111111111111
1111111111111111111
11111110P0111111111
110C000000010001111
1100000000000001111
1100000101000001111
1101001C00010E11111
1111111111111111111
1111111111111111111
