1111111111111111111
1111111111111111111
1111111111111111111
1111111111111111111
1111111111111111111
111111100P111111111
110C000000010001111
1100000000000111111
100000010100E000C01
1101001C0100C001111
1111111111111111111
1111111111111111111
1111111111111111111
