111111111111111111111111111111
100000F00000000000000000000101
100000000011111111000000000101
100000000000000000000000000101
100011111111111000000100000101
10E00100000000000C001010000101
10C000001111000000000100000001
10P0100000C1000000000000100101
100010000111111111111000000001
100010F00000111110000100000101
100010000001000000111000011101
100010000000111000000000000101
100010000000000000010000000101
1000100F000F000000000000000101
111111111111111111111111111111
