1111111111111
1111000001111
111100E001111
1111000001111
111111C111111
10000101000C1
1F0C00000CF01
10C00111000P1
1111111111111