11111111111111
11111111111111
10000C00000111
10100E01010001
1000111F100101
11011C0P000101
11111111111111