11111111111111
11111111111111
1000000C100111
10100E01010001
1000P000100101
11C110F00001C1
11111111111111