11111111111111
1C100E01C10001
100C0000000F01
10F0111F100101
11C011P0C001C1
11111111111111