111111111111111
100C000000E0001
10000F000000001
1P00000000000C1
111111111111111