11111111111111
11111111111111
1000000C100111
10100E11010001
1000C000100101
11C110FP0001C1
11111111111111