11111111111111
11111111111111
10000100000111
10100E01010001
1000101F100101
1101110PC00101
11111111111111