1111111
1C100C1
1E0F0C1
100P0C1
1111111