1111111
1E000C1
100F0C1
100P0C1
1111111