111111
1C0001
10E001
100P01
111111

